                                                                                                                                                                                                        
                                                                                                                                                                                                        
                                                                                                                                                                                                        
                                                                                                                                                                                                        
                      ...............      ............... ........................... ................ ......................... . ...... .  .....   ............                                      
                     ................      ..................................   ...............................  ................ .......  .. ......................                                    
                     ................      ................            .....      ..............  ............     ....  .. .....   ...............   ..............                                    
                     ...... .. ......      ......    ......            ......    ................ .............  .......            ...............      ....... ..                                     
                  .  ...... .........      ........  ......            .................................................           ................      ......  .                                      
                     ................      ................            ............... .................................    ...                           ..........                                    
                     ................      ................            ...................... .. .......................    ...                           ..........                                    
                     ................      ................            ......   .............    .............   .......     .                            ..........                                    
                     ...............   ... ................            .....     ............................     ......                                        ...                                     
            ...      ......................................            ....... .........................................     ...   ......    ......             ...                                     
             ..      ...............   ....................            ................................................      ...   ....... .........           .....       ..                           
          .....                                                                             ......                           ...    ................... . .... .....      ..    .                       
             ..              .                                ...                            .....     ..        .         .....   .................................               ..                   
             .             ....         ....              .........     ......   .....       .....   ...........................    ...............................                                     
          .....    ............       ........             ........    ......    ..          .....    ............... .....                                                     ....                    
          .....   .............      ........                                                ....       ...   ....                                 ....                  ..     .....                   
          .....    .       ....     ........                                                 ...                                                 ........  ....  ..........     .....                   
          .....                 . ...........    ............................................................................................     .............  .........      .....                   
          .....    ...       ...............    ..............................................................................................       .....................      .....                   
          ....    ....  ......   ...........     .............................................................................................       ..............  ........   ....                    
          .....   ...   ...       . .  .   ..   .............................................. ...............................................       ........  ...     .....    .....                   
          ....                                   ...   ........   ........   ........   .....  ......    ........  ........   .........  .....                                  ....                    
          ...................................    ..    .......    .......     .......    ............    .......    .......    .......    ...                                   ....                    
          ..........................................................................................................................................................................                    
          ...................................   ............................................     ............................................   .....................................                   
          ....        ..                                                                  ..     ...                                                                  ..        .....                   
         ......      .....                                                                 ..   ..                                                                   ....      ......                   
          ....       .....                       ..........................                                                                   .                      ....       ....                    
          ....       .....................      ...........................                                        ....   .             .......       .        .... .....       ....                    
          ....       .....................      .................      . .                                         ......             ........      .....................      .....                    
          ....       .....................      ................       ....                                        .... .....       ..........      .....................       ....                    
         .....       .....................      ........ ........      ......... ..........   .    .......... ...............       ............    ............... .....      .....                    
         .....       ..........   ........      .....     .......     .................... ..................................      ..............   ............ .  .....      .....                    
          ....       .....................       ...............       ....       ..........................       ....         .................   .....................       ....                    
         ......      .....................      ................      .....       ..........................       ....          .......            .....................      ......                   
          .....      .....................       ...............      .....       ..........................      ......                            ......................     ......                   
          ....                                   ...............       ....       ..........................       ....                      .                                  ....                    
          ....                                   ...............      .....       ..........................       .... ............ ..    ......                               ....                    
          ....                                                        .....       ..........................       .... ............ ..     ......                              ....                    
          ......                                                       ....       ..........................       ....      ...........                                        ....                    
          ................................      ................       ....       ..........................       ....      ...........            ................................                    
          ................................       ...............      .....       ...........................      .....     ...........            ................................                    
                                     .....      ........ ...........  .....       ..........................       ....                             ....                                                
                                     .....      .......   ..........  .....       .................... ......      .....                            .....                                               
                                     .....       ...................  .....       ..     ............    ...       .....                            .....                                               
                         ... .       .....       ...............       ....       ..      ...........    ...       .... . ........                  .....                                               
                          .......    .....      ................      .....       ....  .....................      ................. . .            .....                                               
                            ....     .....       .         .....      .....       ..........................       ....   ..............            ....                                                
                                     .....                            .....       ..........................       ....       ..........            ....                                                
                                     .....                            .....      ....  ............... ......      .....      ..........            .....                                               
                                     .....                            .....       ..    .............    ...       ....                             ....                                                
                                     .....       ...............      .....      .....  ..............   ...       ....                             .....                                               
                                     .....      ................      .....      ...........................       ....                         .   .....                                               
                                     .....       ...............      .....       ..........................       ....                      ....   .....                                               
                     .....................       ...... . ........... .....      ...........................       .... ............ . .    .....   ...................                                 
                     .....................       .................... .....       ..    .............   ....       ....  ........... . .   ......    ....................                               
                     .....                       ...............      .....       ...    ............    ...       ....      ...........    .....                   .....                               
                .    .....                      ................      .....      ...........................       ....      ...........      ......                .....                               
                .    ....                        .... ..........      .....       ..........................       ....       ..........      .......               .....                               
                .    ....                                             .....              .. ..... ..               ....                       ................      .....                               
                     .....                                            .....                 .....                  ....                         . ..                .....                               
                     ....                                             .....               ..........               ....                                             .....                               
                     .............................................................................................................................................. ....                                
                     ...................................................................................................................................................                                
                     ...  ..                          ..........                                                             ..... ........................... ..... ...                                
                     ...                                   .....                                                              ....                                   ...                                
                     ....                                  .....                                                              ....                                  ....                                
                     .... .                                .....                   .....     ...                              ....                                  ....                                
                     ...............................       ...............                                         ................     ................................                                
                     ................................       ...............                                        ...............       ...............................                                
                                     ................                 .....                                        ....                  ...............                                                
                     ......... ...   ................                 .................................................                 ................  ..   .    . ..                                
                     .............   ................                  .... ...........................................                  ...............  ...............                               
                    ..............   ..........................                             .....                             .... ..    ...............  ..............                                
                    .......  . ...   ......... .................     .                      .....                            .................... ......  .....    ......                               
                     .............   ...........................    .......   .....         .....      ....    ...           ...........................  ...............                               
                     ...........................................    ...............         .....      ....   ....            ..........................  ...............                               
                     .............   ...........................   ......                   .....                     ...    ...........................  ...............                               
                                     ...........................  ......                    .....                    .....   ...........................                                                
                     ...........................................   ....     .................  . .................  ......   ...........................................                                
                    ............................................   .....    ...   .............. ..........  .....   .....   ............................................                               
                        . ..                                        ....    ..     .......................     ...    ...     ......... .......... .....................                                
                                                                    ..      ....  .........................   ....                                                                                      
                                                                            ......................................                                                                                      
                          .....................                             .................. ..................                           ....         ..........                                     
                          .....................       ..................................................................................    .......                                                     
                     .    .....................       .....................................      .. ............. ......................     .......                                                    
                          .....................       ....                  ................. ..... .............                  .....      ...                                                       
                          .....  .. ............ .    ....                 .......................................                 .....                                                                
                          ................................                 ...    ...........  .... ......    ...     ........     .....                                                                
                          .........................  .....       .....     ...     ..........  .... ......    ...      ........    .....                                                                
                                                      ....      ........   ................      .. ..............      .......    .....                                                                
                                                     .....       .......    ............        .   .............       .......    ....                                                                 
                          .....................      .....         .                                                    ......     ....       .....................                                     
                          .....................      .....                                                                         .....      .....................                                     
                          .....................       ....                                                                         ....       .....................                                     
                          ...... . ............      .....    .................................................................    .....      ............ ........                                     
                          ..... .. ............      .....    ...........   .....................................  ............    ....       ........... .........                                     
                          .....................       ....    ..........     ..................................     ...........    ....       .....................                                     
                          .....................      .....    ............ .....................................    ...........    .....      .....................                                     
                           ....................      .....    .................................................................    ....       .....................                                     
                               ....                   ....    .................................................................    ....                  ...                                            
                               .....                 .....     .............................. . ...............................    .....                 ....                                           
                                ...                   ....     ..........   ................ ..................    ............    ....                  ....                                           
                               ........   ...        .....     ..........    ..................................     ...........    ......    ..         .....                                           
                               ...........................     .................................................. .............    ...........................                                          
                               ...........................     ................................................................    .... ......................                                          
                               .....                           ..     .................................................     ..                           .....                                          
                               .....                          ....    .................................................    .....                         .....                                          
                               .....    .............     .......     ...    ... .... ... ...... ..... .... ..... ....     .............     ........    .....                                          
                               .....    ............  .. ........     ....                                         ...     .........................     .....                                          
                               .....                                  .....                                       .....                                  .....                                          
                               .....                                  .....                                       .....                                  ....                                           
                               ............................................                                       ............................................                                          
                               ...........................................                                        ...........................................                                           
                                                                                                                                                                                                        
                                                                                                                                                                                                        
                                                                                                                                                                                                        
                                                                                                                                                                                                        
                                                                                                                                                                                                        
                                                                                                                                                                                                        
                                                                                                                                                                                                        